NO assets/textures/cracks-gray.xpm
SO assets/textures/cracks-gray.xpm
WE assets/textures/cracks-gray.xpm
EA assets/textures/cracks-gray.xpm


F 180,180,180
C 180,180,180

11111111111111111111
11111110000000001
11111100000000001
100000000111000001
10000000000000000001
1111110000110000001
1111110000000000001
111111000111110000001
10000000011 1000000001
1000000001111100000001
1100000000000000000111111
111111W000000000000111
111111000000000000001
10000000011110000000000001
111111111111111111111