NO assets/textures/morrocan-texture.xpm
SO assets/textures/morrocan-texture.xpm
WE assets/textures/morrocan-texture.xpm
EA assets/textures/morrocan-texture.xpm
F 0, 0,    0213
C 190,216,226

1111111111111
111111N000001
1111110000001
1000000001111
1111111111111