NO assets/textures/black-green.xpm
SO assets/textures/black-green.xpm
WE assets/textures/cracks-fire.xpm
EA assets/textures/cracks-fire.xpm


C 135,206,235
F 0,0,0

11111111111111111111
11111110000000001
11111100000000001
100000000111000001
10000000000000000001
1111110000110000001
1111110000000000001
111111000000000000001
100000000111000000001
100000000000000000001
1100000000000000000111111
111111W000000000000111
1111110000000000000001
10000000011110000000000001
111111111111111111111