NO assets/textures/tile64.xpm
SO assets/textures/tile64.xpm
WE assets/textures/tile64.xpm
EA assets/textures/tile64.xpm


F 180,180,180
C 180,180,180

11111111111111111111
11111110000000001
111111000000W0001
111111111111111111